"Map data for the breakout game				",0,0,0,0,,,,
1,1,1,1,1,1,1,1,1
4,4,4,4,4,4,4,4,4
2,2,2,2,2,2,2,2,2
1,1,1,1,1,1,1,1,1
,,6,6,6,6,6,,
,5,5,5,5,5,5,5,
,,,1,1,1,,,
3,3,3,4,4,4,3,3,3
2,2,2,3,3,3,2,2,2
1,1,1,2,2,2,1,1,1
