"Map data for the breakout game				",0,0,0,0,,,,,
5,5,5,5,5,5,5,5,5,5
4,4,4,4,4,4,4,4,4,4
7,7,7,7,7,7,7,7,7,7
6,6,6,6,6,6,6,6,6,6
1,7,1,7,1,1,7,1,7,1
5,5,5,5,5,5,5,5,5,5
4,4,4,4,4,4,4,4,4,4
7,7,7,7,7,7,7,7,7,7
6,6,6,6,6,6,6,6,6,6
1,7,1,7,1,1,7,1,7,1
